  -10    _   10    _    _
  -10    _    #    _    _
  -10    _    1    _    _
  -10    _    #    #    _
  -10    S    _    _    _